NO ./textures/east.xpm
SO ./textures/east.xpm
WE ./textures/west.xpm
EA ./textures/west.xpm
C 42,42,42
F 79,79,79
11111111111111111111111111111111111111
100S0000000000000000000000000000000001
10000011111111111111111111111111110001
1000001                  1111111000001
1000001                  100000000001
100000111111111111111111100000111111
1111111000000000100000001000001
  100001000000000000000001000001
  100000000000001000000010000001
  111111000000001111111111111101
       1100000001000000000000001
        110000000000000000000001
         1100000100000000000011
          11111111111111111111