

NO ./textures/bluestone.xpm
SO ./textures/colorstone.xpm
WE ./textures/greystone.xpm
EA ./textures/redbrick.xpm

C 50,30,1



F 0,50,50


        1111111111111111111111111
        1000000000110000000000001
        1011000001110001000000001
        100100000000E000000000001     1
111111111011000001110000000000001    101
101000000011000001110111111111111     1
11110111111111011100000010001
11110111111111011101010010001
11000000110101011100000010001
10000000000000001100000010001
1000000000000000110101001000111111111111111111111111111
1100000111010101111101111000000000000000000000000000001
1000000111100001111000000000000000000000000111111111101
1100000111010101111101111000000000000000000000000000101
11110111 1110101 101111010001111111111111111111111101111
11111111 1111111 111111111111                   11111111