NO ./textures/bluestone.xpm
SO ./textures/colorstone.xpm
WE ./textures/greystone.xpm
EA ./textures/redbrick.xpm
C 66,60,60
F 229,99,7


11111111111111111111111111111111111111
100E0000000000000000000000000000000001
10000011111111111111111111111111110001
1000001                  1111111000001
1000001                  100000000001
100000111111111111111111100000111111
1111011000000000100000001000001
  100001000000000000000000000001
  100000000000001000000010000001
  111111000000001111111111111101
       1100000001000000000000001
        110000000000000000000001
         1100000100000000000011
          11111111111111111111